1111111111111
11C0000000C11
1C000000000C1
1000000000001
100000P0000E1
1000000000001
1C000000000C1
11C0000000C11
1111111111111