1111111111111111111111111111111111
1E00000000000F0C00000C000000000001
1010010011110010000010000001100001
1010010010000010000010000010010001
1011110011110010000010000010010001
1010010010000010000010000010010001
1010010011110011110011110001100001
1P0000000C00C0000000000000000000C1
1111111111111111111111111111111111