1111111111111111111111111111111111
1000111111000111111000111111000001
1000C000000C000000C000000C00000001
1011111111111111111111111111100001
1010000000000000000000000000000001
1010111111000111111111111111000001
1000C100000C000C000100000C00000001
1010101111111111111111111111110001
1000001000000000E00000000000000001
1000111111000111111000111111110001
1000C100000C000000000000C000000011
1000001111110001111100000111111001
1000000000000000000000000000000001
1011111111111111111111111111111111
1P00000000000000000000000000000011
1111111111111111111111111111111111
