1111111111111111111
1C000000C00F0001111
1001011111000001111
10P10000C0000001111
1001F00000000001111
1000111110110000FE1
1111111111111111111